1111111111111111111111111111111111
1E0000000000000C00000C000000000001
1010010100100000101001000000100101
101001001010101000100100000010C101
1P0000000C00C0000000000000001111C1
100000001111100000C000000000000001
100C0000000C10C0000000000C00000001
11110000000010000000000000000C0001
1111111111111111111111111111111111