1111111111111111111111111111111111
1EX0000000X0000C00000C000000000001
1010010100100000101001000000100101
10100X00101X1010X010010000001XC101
1P0000000C00C00000000X0000001111C1
100000001111100000C000000000000001
100C000000XC10C00X0000000C00000001
1111X0000000100000000X0000000C0001
1111111111111111111111111111111111